##S##S##S##
##P##P##P##
SPPPBBBPPPS
##P##P##P##
##B##P##B##
SPPPPEPPPPS
##B##P##B##
##P##P##P##
SPPPBPBPPPS
##P##P##P##
##S##S##S##