##P##S##P##
##P##B##P##
PPPPBBPPPPP
##P##B##P##
##B##B##B##
SPPPPPPPPPS
##B##P##B##
##P##P##P##
PPPPBPBPPPP
##P##P##P##
##P##S##P##