##P##S##P##
##P##P##P##
PPPPBBBPPPP
##P##P##P##
##B##P##B##
SPPPPEPPPPS
##B##P##B##
##P##P##P##
PPPPBPBPPPP
##P##P##P##
##P##S##P##