##P##S##P##
##P##B##P##
PPPPBBBPPPP
##P##B##P##
##B##B##B##
SPPPPEPPPPS
##B##P##B##
##P##P##P##
PPPPBPBPPPP
##P##P##P##
##P##S##P##