##P##S##P##
##P##P##P##
PPPPBPBPPPP
##P##P##P##
##B##P##B##
SPPPPPPPPPS
##B##P##B##
##P##P##P##
PPPPBPBPPPP
##P##P##P##
##P##S##P##